1 1 11 11 5 5 5 11 11 3 3 11 5 11 11 11 11 11 10 10 10 10 10 10 10 10 10 10 10 10 10 10 11 11 11 11 11 5 11 3 3 11 11 5 5 5 11 11 1 1
1 1 11 11 5 7 5 11 11 3 3 11 5 5 11 5 11 11 11 11 11 11 11 11 11 11 11 11 11 11 11 11 11 11 5 11 5 5 11 3 3 11 11 5 7 5 11 11 1 1
1 1 11 11 5 7 5 11 11 3 3 11 5 5 11 5 5 11 11 11 11 11 11 5 5 5 5 11 11 11 11 11 11 5 5 11 5 5 11 3 3 11 11 5 7 5 11 11 1 1
1 1 11 11 5 7 5 11 11 3 3 11 5 5 11 5 5 11 5 11 11 11 5 5 7 7 5 5 11 11 11 5 11 5 5 11 5 5 11 3 3 11 11 5 7 5 11 11 1 1
1 1 11 11 5 5 5 11 11 3 3 11 5 5 11 5 5 11 5 5 11 11 5 5 7 7 5 5 11 11 5 5 11 5 5 11 5 5 11 3 3 11 11 5 5 5 11 11 1 13
1 1 11 11 5 5 5 11 11 3 3 11 5 5 11 5 5 11 5 5 11 11 11 5 5 5 5 11 11 11 5 5 11 5 5 11 5 5 11 3 3 11 11 5 5 5 11 11 1 1
1 1 11 11 11 11 11 11 11 3 3 11 5 5 11 5 5 11 5 5 11 11 11 11 11 11 11 11 11 11 5 5 11 5 5 11 5 5 11 3 3 11 11 11 11 11 11 11 1 1
1 1 11 11 11 11 11 11 11 3 3 11 11 5 11 5 5 11 5 5 11 11 11 10 4 4 10 11 11 11 5 5 11 5 5 11 5 11 11 3 3 11 11 11 11 11 11 11 1 1
1 1 1 11 11 11 11 11 1 3 3 11 11 11 11 5 5 11 5 5 11 11 4 10 4 4 10 4 11 11 5 5 11 5 5 11 11 11 11 3 3 1 11 11 11 11 11 1 1 3
1 1 1 1 1 1 1 1 1 3 3 11 11 11 11 11 5 11 5 5 11 11 4 10 4 4 10 4 11 11 5 5 11 5 11 11 11 11 11 3 3 1 1 1 1 1 1 1 1 3
1 1 1 1 1 1 1 1 1 3 3 3 11 11 11 11 11 11 5 5 11 11 4 10 4 4 10 4 11 11 5 5 11 11 11 11 11 11 3 3 3 1 1 1 1 1 1 1 3 3
3 1 1 1 1 1 1 1 3 3 3 3 1 11 11 11 11 11 11 5 11 11 4 10 4 4 10 4 11 11 5 11 11 11 11 11 11 1 3 3 3 3 1 1 1 1 1 3 3 3
3 3 1 1 1 1 1 1 3 3 3 3 1 1 11 11 11 11 11 11 11 11 4 10 4 4 10 4 11 11 11 11 11 11 11 11 1 1 3 3 3 3 3 3 1 1 3 3 3 3
3 3 3 1 1 1 1 3 3 3 3 1 1 1 1 1 11 11 11 11 11 11 4 10 4 4 10 4 11 11 11 11 11 11 1 1 1 1 1 3 3 3 3 3 3 3 3 3 3 3
3 3 3 3 3 1 3 3 3 3 3 1 1 1 1 13 1 1 1 1 11 11 11 11 11 11 11 11 11 11 1 1 1 1 1 1 1 1 1 3 3 3 3 3 3 3 3 3 3 3
3 3 3 3 3 3 3 3 3 3 1 1 1 1 1 1 1 1 1 1 1 1 1 1 1 1 1 1 1 1 1 1 1 1 1 1 1 1 1 1 3 3 3 3 3 3 3 3 3 1
3 3 3 3 3 3 3 3 3 1 1 1 1 1 1 1 1 1 1 1 1 1 1 1 1 1 1 1 1 1 1 1 1 1 1 1 1 1 1 3 3 3 3 3 3 3 3 3 3 1
3 3 3 3 3 3 3 3 3 3 3 1 1 1 1 1 1 1 1 1 1 1 1 1 1 1 1 1 1 1 1 1 1 1 1 1 1 1 3 3 3 3 3 3 3 3 3 3 1 1
3 3 3 3 3 3 3 3 3 3 3 3 3 1 1 1 1 1 1 1 1 1 1 1 1 1 1 1 1 1 1 1 1 1 1 1 3 3 3 3 3 3 3 3 3 3 3 1 1 1
1 3 3 3 3 3 3 3 3 3 3 3 3 3 3 3 1 1 1 1 1 1 1 1 1 1 1 1 1 1 1 1 1 1 3 3 3 3 3 3 3 3 3 3 3 3 1 1 1 1
1 1 1 3 3 3 3 3 3 3 3 3 3 3 3 3 3 3 3 3 1 1 1 4 4 4 4 1 1 1 3 3 3 3 3 3 3 3 3 3 3 3 3 3 1 1 1 1 1 1
1 1 1 1 1 3 3 3 3 3 3 3 3 3 3 3 3 3 3 3 3 3 3 4 4 4 4 3 3 3 3 3 3 3 3 3 3 3 3 3 3 3 3 1 1 1 1 1 1 1
1 1 1 1 1 1 1 1 3 3 3 3 3 3 3 3 3 3 3 3 3 3 3 4 4 4 4 3 3 3 3 3 3 3 3 3 3 3 3 3 3 3 1 1 1 1 1 1 1 1
1 1 1 1 1 1 1 1 1 1 3 3 3 3 3 3 3 3 3 3 3 3 3 4 4 4 4 3 3 3 3 3 3 3 3 3 3 3 3 3 1 1 1 1 1 1 1 1 1 2
1 1 1 1 1 1 1 1 1 1 1 1 3 3 3 3 3 3 3 3 3 3 3 4 4 4 4 3 3 3 3 3 3 3 3 3 3 1 1 1 1 1 1 1 1 1 1 1 1 2
1 1 1 1 1 1 1 1 1 1 1 1 1 1 1 3 3 3 3 3 3 3 3 4 4 4 4 3 3 3 3 3 3 3 3 1 1 1 1 1 1 1 1 1 1 1 1 1 2 2
1 1 1 1 1 13 13 1 1 1 1 1 1 1 1 1 1 1 1 3 3 3 3 4 4 4 4 3 3 3 3 1 1 1 1 1 1 1 1 1 1 1 1 1 1 1 1 1 2 2
1 1 1 13 13 13 1 13 1 1 1 1 1 1 1 1 1 1 1 1 1 1 1 2 2 2 2 1 1 1 1 1 1 1 1 1 13 13 13 1 13 13 1 1 1 1 1 2 2 2
1 1 13 13 13 13 13 1 1 1 1 1 1 1 1 1 1 1 1 1 1 1 1 2 2 2 2 1 1 1 1 1 1 13 13 1 13 1 13 13 1 1 13 1 1 1 1 2 2 2
1 1 1 1 13 13 1 1 1 1 1 1 1 1 1 1 1 1 1 1 1 1 1 2 2 2 2 1 1 1 1 1 1 1 1 13 13 13 13 13 13 13 1 1 1 1 2 2 2 2
1 1 1 1 1 1 1 1 1 1 1 1 1 1 1 1 1 1 1 1 1 1 1 2 2 2 2 2 1 1 1 1 1 1 1 1 1 1 13 13 13 1 1 1 1 1 2 2 2 2
1 1 1 1 1 1 1 1 1 1 1 1 1 1 1 1 1 1 1 1 1 1 1 2 2 2 2 2 2 1 1 1 1 1 1 1 1 1 1 1 1 1 1 1 1 1 2 2 2 2
1 1 1 1 1 1 1 1 1 1 1 1 1 1 1 1 1 1 1 1 1 1 1 1 2 2 2 2 2 2 2 1 1 1 1 1 1 1 1 1 1 1 1 1 1 2 2 2 2 2
1 1 1 1 1 1 1 1 1 1 1 1 1 1 1 1 1 1 1 1 1 1 1 1 2 2 2 2 2 2 2 2 2 1 1 1 1 1 1 1 1 1 1 2 2 2 2 2 2 1
1 1 1 1 1 1 1 1 1 1 1 1 1 1 1 1 1 1 1 1 1 1 1 1 1 2 2 2 2 2 2 2 2 2 2 2 1 1 1 2 2 2 2 2 2 2 2 2 2 1
1 1 1 1 1 1 1 1 1 1 1 1 1 1 1 1 1 1 1 1 1 1 1 1 1 1 2 2 2 2 2 2 2 2 2 2 2 2 2 2 2 2 2 2 2 2 2 2 1 1
1 1 1 1 1 1 1 1 1 1 1 1 1 1 1 1 1 1 1 1 1 1 1 1 1 1 1 2 2 2 2 2 2 2 2 2 2 2 2 2 2 2 2 2 2 2 2 1 1 1
1 1 1 1 1 1 1 1 1 1 1 1 1 1 1 1 1 1 1 1 1 1 1 1 1 1 1 1 1 1 2 2 2 2 2 2 2 2 2 2 2 2 2 2 2 1 1 1 1 1
1 1 1 1 1 1 1 1 1 1 1 1 1 1 1 1 1 1 1 1 1 1 1 1 1 1 1 1 1 1 1 1 2 2 2 2 2 2 2 2 2 2 2 1 1 1 1 1 1 1
1 1 1 1 1 1 1 1 1 1 1 1 1 1 1 1 1 1 1 1 1 1 1 1 1 1 1 1 1 1 1 1 1 1 1 2 2 2 2 2 1 1 1 1 1 1 1 1 1 1
1 1 1 1 1 1 1 1 1 1 1 1 1 1 1 1 1 1 1 1 1 1 1 1 1 1 1 1 1 1 1 1 1 1 1 1 1 1 1 1 1 1 1 1 1 1 1 1 1 1
1 1 1 1 1 1 1 1 1 1 1 1 1 1 1 1 1 1 1 1 1 1 1 1 1 1 1 1 1 1 1 1 1 1 1 1 1 1 1 1 1 1 1 1 1 1 1 1 1 1
1 1 1 1 1 1 1 1 1 1 1 1 1 1 1 1 1 1 1 1 1 1 1 1 1 1 1 1 1 1 1 1 1 1 1 1 1 1 1 1 1 1 1 1 1 1 1 1 1 1
1 1 1 1 1 1 1 1 1 1 1 1 1 1 1 1 1 1 1 1 1 1 1 1 1 1 1 1 1 1 1 1 1 1 1 1 1 1 1 1 1 1 1 1 1 1 1 1 1 1
1 1 1 1 1 1 1 1 1 1 1 1 1 1 1 1 1 1 1 1 1 1 1 1 1 1 1 1 1 1 1 1 1 1 1 1 1 1 1 1 1 1 1 1 1 1 1 1 1 1
1 1 1 1 1 1 1 1 1 1 1 1 1 1 1 1 1 1 1 1 1 1 1 1 1 1 1 1 1 1 1 1 1 1 1 1 1 1 1 1 1 13 13 1 1 1 1 1 1 1
1 1 1 1 1 1 1 1 1 1 1 1 1 1 1 1 1 1 1 1 1 1 1 1 1 1 1 1 1 1 1 1 1 1 1 1 1 1 13 1 13 13 1 1 1 1 1 1 1 1
1 1 1 1 1 1 1 1 1 1 1 1 1 1 1 1 1 1 1 1 1 1 1 1 1 1 1 1 1 1 1 1 1 1 1 1 1 13 13 13 13 13 13 13 13 1 1 1 1 1
1 1 1 1 1 1 1 1 1 1 1 1 1 1 1 1 1 1 1 1 1 1 1 1 1 1 1 1 1 1 1 1 1 1 1 1 1 1 1 13 13 13 1 1 1 1 1 1 1 1
1 1 1 1 1 1 1 1 1 1 1 1 1 1 1 1 1 1 1 1 1 1 1 1 1 1 1 1 1 1 1 1 1 1 1 1 1 1 1 1 1 1 1 1 1 1 1 1 1 1