1 1 3 3 3 3 1 1 1 1 1 1 1 1 1 1 1 1 1 1 1 1 1 1 1 1 1 1 1 1 2 2 2 2 1 1 1 1 1 1 1 1 1 1 1 1 1 1 1 1
1 1 3 3 3 3 1 1 1 1 1 1 1 1 1 1 1 1 1 1 1 1 1 1 1 1 1 1 1 1 2 2 2 2 1 1 1 1 1 1 1 1 1 1 1 1 1 1 1 1
1 1 1 3 3 3 1 1 1 1 1 1 1 1 1 1 1 1 1 1 1 1 1 1 1 1 1 1 1 1 2 2 2 2 1 1 1 1 1 1 1 1 1 1 1 1 1 1 1 1
1 1 1 3 3 3 3 1 1 1 1 1 1 1 1 1 1 1 1 1 1 1 1 1 14 1 14 1 1 2 2 2 2 2 1 1 1 1 1 1 1 1 1 1 1 1 1 1 1 1
1 1 1 3 3 3 3 1 1 1 1 1 14 1 1 1 1 1 1 1 1 1 1 14 1 14 1 1 1 2 2 2 2 2 1 1 1 1 1 1 1 1 1 1 1 1 1 1 1 1
1 1 1 3 3 3 3 3 1 1 14 14 14 14 1 1 1 1 1 1 1 1 14 14 14 14 14 1 2 2 2 2 2 2 1 1 1 14 14 1 1 1 1 1 1 1 1 1 1 1
1 1 1 1 3 3 3 3 1 14 14 14 1 1 1 1 1 1 1 1 1 14 14 14 14 1 1 1 2 2 2 2 2 1 1 1 14 1 14 14 14 1 1 1 1 1 1 1 1 1
1 1 1 1 3 3 3 3 1 1 1 1 1 1 1 1 1 1 1 1 1 1 1 1 1 1 1 2 2 2 2 2 1 1 1 1 1 14 1 14 14 14 1 1 1 1 1 1 1 1
1 1 1 1 3 3 3 3 1 1 1 1 1 1 1 1 1 2 2 1 1 1 1 1 1 1 2 2 2 2 2 1 1 1 1 1 1 14 14 14 14 1 14 1 1 1 1 1 1 1
1 1 1 1 3 3 3 3 1 1 1 1 1 1 1 1 1 2 2 2 1 1 1 2 2 2 2 2 2 2 2 2 2 1 1 1 1 1 1 14 14 14 14 1 1 1 1 1 1 1
1 1 1 1 3 3 3 3 1 1 1 1 1 1 1 1 1 2 2 2 2 2 2 2 2 2 2 2 2 2 2 2 2 2 2 2 1 1 1 1 1 14 1 1 1 1 1 1 1 1
1 1 1 1 3 3 3 3 1 1 1 1 1 1 1 1 1 1 2 2 2 2 2 2 2 2 2 2 2 2 2 2 2 2 2 2 2 1 1 1 1 1 1 1 1 1 1 1 1 1
1 1 1 3 3 3 3 3 1 1 1 1 1 1 1 1 1 1 1 2 2 2 2 2 2 2 2 2 2 2 2 2 2 2 2 2 2 2 1 1 1 1 1 1 1 1 1 1 1 1
1 1 1 3 3 3 3 3 1 1 1 1 1 1 1 1 1 1 2 2 2 2 2 2 2 1 1 1 1 1 1 2 2 2 2 2 2 2 2 1 1 1 1 1 1 1 1 1 1 1
1 1 1 3 3 3 3 1 1 1 1 1 1 1 1 1 1 1 2 2 2 2 2 1 1 1 1 1 1 1 1 1 1 2 2 2 2 2 2 2 1 1 1 1 1 1 1 1 1 3
1 1 3 3 3 3 3 1 1 1 1 1 1 1 1 1 1 2 2 2 2 2 1 1 1 1 1 1 1 1 1 1 1 1 1 2 2 2 2 2 1 1 1 1 1 1 1 1 1 3
1 1 3 3 3 3 3 1 1 1 1 2 2 1 1 1 1 2 2 2 2 2 1 1 1 14 14 14 14 14 14 1 1 1 1 1 2 2 2 2 1 1 1 1 2 2 1 1 3 3
1 1 3 3 3 3 1 1 1 1 1 2 2 2 1 1 1 2 2 2 2 1 1 1 14 1 14 14 14 14 14 14 1 1 1 1 2 2 2 2 2 1 1 2 2 2 1 1 3 3
1 1 3 3 3 3 1 1 1 1 1 2 2 2 2 2 2 2 2 2 2 1 1 1 14 1 1 1 1 1 14 14 1 1 1 1 1 2 2 2 2 2 2 2 2 2 1 1 3 3
1 1 3 3 3 3 1 1 1 1 1 1 2 2 2 2 2 2 2 2 2 1 1 1 14 14 1 1 1 1 1 14 1 1 1 1 1 1 2 2 2 2 2 2 2 1 1 3 3 3
1 1 3 3 3 3 1 1 14 1 1 1 1 1 1 1 2 2 2 2 2 1 1 1 1 14 14 2 2 14 14 1 1 1 1 1 1 1 1 1 2 2 2 2 1 1 1 3 3 3
1 1 3 3 3 3 1 1 14 14 1 1 1 1 1 1 1 2 2 2 2 1 1 1 1 1 2 2 2 1 1 1 1 1 1 1 1 1 1 1 1 1 1 1 1 1 3 3 3 3
1 1 3 3 3 3 1 1 14 14 1 1 1 1 1 1 2 2 2 2 2 2 1 1 2 2 2 2 2 1 1 1 1 1 1 1 1 1 1 1 1 1 1 1 1 3 3 3 3 1
1 1 3 3 3 3 3 1 14 14 1 1 1 1 1 1 2 2 2 2 2 2 2 2 2 2 2 2 1 1 1 1 1 1 1 1 1 1 1 1 1 1 14 1 1 3 3 3 3 1
1 1 1 3 3 3 3 1 1 14 14 1 1 1 1 2 2 2 2 2 2 2 2 2 2 2 1 1 1 1 1 1 1 1 1 1 1 1 1 1 1 14 14 1 3 3 3 3 3 1
1 1 1 3 3 3 3 1 1 1 1 1 1 2 2 2 2 2 2 2 2 2 2 2 2 1 1 1 1 1 1 1 1 1 1 1 1 1 1 1 1 14 1 1 3 3 3 3 3 1
1 1 1 3 3 3 3 3 1 1 1 1 2 2 2 2 2 2 2 2 2 2 2 2 2 2 2 1 1 1 1 1 1 1 1 1 1 1 1 1 1 1 1 3 3 3 3 3 1 1
1 1 1 1 3 3 3 3 3 1 1 2 2 2 2 2 2 2 1 1 2 2 2 2 2 2 2 2 1 1 1 1 1 1 1 1 1 1 1 1 1 1 1 3 3 3 3 3 1 1
1 1 1 1 3 3 3 3 3 3 4 4 2 2 2 2 1 1 1 1 1 1 2 2 2 2 2 2 1 1 1 1 1 1 1 1 1 1 1 1 1 1 3 3 3 3 3 1 1 1
1 1 1 1 1 3 3 3 3 4 4 4 4 2 1 1 1 1 1 1 1 1 1 1 2 2 2 2 2 1 1 1 1 1 2 2 1 1 1 1 1 1 3 3 3 3 1 1 1 1
1 1 1 1 1 1 3 3 4 4 4 4 4 1 1 1 1 1 1 14 14 1 1 1 1 2 2 2 2 2 1 1 1 2 2 2 1 1 1 1 1 3 3 3 3 3 1 1 1 1
1 1 1 1 1 1 1 4 4 4 4 4 3 3 1 1 1 1 1 14 14 14 1 1 1 2 2 2 2 2 2 2 2 2 2 2 1 1 1 1 3 3 3 3 3 1 1 1 1 1
1 1 1 1 1 1 2 4 4 4 4 3 3 3 3 3 1 1 1 1 1 14 14 1 1 1 2 2 2 2 2 2 2 2 2 1 1 1 1 3 3 3 3 3 1 1 1 1 1 1
1 1 1 1 2 2 2 2 4 4 3 3 3 3 3 3 3 3 1 1 1 1 1 1 1 1 2 2 2 2 2 1 1 1 1 1 1 1 3 3 3 3 3 3 1 1 1 1 1 1
1 1 2 2 2 2 2 2 2 1 3 3 3 3 3 3 3 3 3 3 1 1 1 1 1 1 2 2 2 2 1 1 1 1 1 3 3 3 3 3 3 3 3 1 1 1 1 1 1 1
2 2 2 2 2 2 2 2 1 1 1 3 3 3 3 3 3 3 3 3 3 3 3 1 1 1 4 4 4 4 1 1 1 3 3 3 3 3 3 3 3 3 1 1 1 1 1 1 1 1
2 2 2 2 2 2 2 1 1 1 1 1 1 3 3 3 3 3 3 3 3 3 3 3 3 3 4 4 4 4 3 3 3 3 3 3 3 3 3 3 3 1 1 1 1 1 1 1 1 1
2 2 2 2 2 2 1 1 1 1 1 1 1 1 1 1 3 3 3 3 3 3 3 3 3 3 4 4 4 4 3 3 3 3 3 3 3 3 3 3 1 1 1 1 1 1 1 1 1 1
2 2 2 1 1 1 1 1 1 1 1 1 1 1 1 1 1 1 1 1 3 3 3 3 3 3 4 4 4 4 3 3 3 3 3 3 3 3 1 1 1 1 1 1 1 1 1 1 1 1
1 1 1 1 1 1 1 1 1 1 1 1 1 1 1 1 1 1 1 1 1 1 1 3 3 3 4 4 4 4 3 3 3 1 1 1 1 1 1 1 1 1 1 1 1 1 1 1 1 1
1 1 1 1 1 1 1 1 1 1 1 1 1 1 1 1 1 1 1 1 1 1 1 1 1 1 2 2 2 2 1 1 1 1 1 1 1 1 1 1 1 1 1 1 1 1 1 1 1 1
1 1 1 1 1 1 1 1 1 1 1 1 1 1 1 1 1 1 1 1 1 1 1 1 2 2 2 2 2 2 2 1 1 1 1 1 1 1 1 1 1 1 1 1 1 1 1 1 1 1
1 1 1 1 1 1 1 13 1 1 1 1 1 1 1 1 1 1 1 1 1 1 2 2 2 2 2 2 2 2 2 2 2 1 1 1 1 1 1 1 1 1 1 1 1 1 1 1 1 1
1 1 1 1 1 1 1 1 1 1 1 1 1 1 1 1 1 1 2 1 2 2 2 2 2 2 2 2 2 2 2 2 2 2 2 1 1 1 1 1 1 1 1 1 1 1 1 1 2 2
1 1 1 1 1 1 1 1 1 1 1 1 1 1 1 2 1 2 2 1 2 1 2 2 2 2 2 2 2 2 2 2 2 2 2 2 2 1 1 1 1 1 1 1 1 2 2 2 2 2
1 1 1 1 1 1 1 1 1 1 1 2 1 2 1 1 2 1 1 2 1 2 2 2 2 1 1 1 1 2 2 2 2 2 2 2 2 2 1 1 1 1 2 2 2 2 2 2 2 2
1 1 1 1 1 1 1 1 1 1 1 1 2 1 2 2 1 1 2 1 2 2 1 1 1 1 1 1 1 1 1 1 2 2 2 2 2 2 2 1 2 2 2 2 2 2 2 2 2 2
1 1 1 1 1 1 1 1 1 1 1 1 1 1 2 1 2 2 1 1 1 1 1 1 1 1 1 1 1 1 1 1 1 1 2 2 2 2 2 2 2 2 2 2 2 2 2 2 2 2
1 1 1 1 1 1 1 1 1 1 1 1 1 1 1 1 1 1 1 1 1 1 1 1 1 1 1 1 1 1 1 1 1 1 1 2 2 2 2 2 2 2 2 2 2 2 1 1 1 1
13 13 1 1 1 1 1 1 1 1 1 1 1 1 1 1 1 1 1 1 1 1 1 1 1 1 1 1 1 1 1 1 1 1 1 1 2 2 2 2 2 2 2 2 1 1 1 1 1 1